










111111111111
111C11111111
111111000011
111E10011011
1P00001C00C1
111111111111





