11111111111111111
10000000000000001
1C0000C011100C001
1P000C1100C0010E1
11111111111111111